# *DO NOT DIRECTLY EDIT THIS FILE, IT IS AUTOMATICALLY GENERATED AND IT IS BASED ON:*
# https://docs.google.com/spreadsheet/ccc?key=0AmQEO36liL4FdDJLWVNMaVV2UmRKSnpXU09MYkdGbEE
aboutDrawio=Om draw.io
access_denied=Åtkomst nekad
actualSize=Verklig storlek
add=Add
addLayer=Add layer
addProperty=Add property
addToExistingDrawing=Lägg till i befintlig ritning
addWaypoint=Lägg till vägpunkt
align=Justera
alignment=Justering
allChangesLost=Alla ändringar kommer gå förlorade!
areYouSure=Are you sure?
ensureDataSaved=Please ensure your data is saved before closing.
allChangesSaved=All changes saved
allChangesSavedInDrive=All changes saved in Drive
allowPopups=Allow pop-ups to avoid this dialog.
alreadyConnected=Knutpunkterna är redan ihopkopplade
apply=Använd
arrange=Ordna
appNotInstalledAlert=Appen är inte installerad. Vänligen installera draw.io i Chrome Web Store och försök igen.
appNotInstalledStatus=Appen är inte installerad.
arrow=Pil
arrows=Pilar
authorizationRequired=Authorization required
authorizeThisAppIn=Authorize this app in {1}:
authorize=Authorize
authorizing=Authorizing
automatic=Automatic
autosave=Autosave
autosize=Ändra storlek automatiskt
background=Background
backgroundColor=Bakgrundsfärg
basic=Enkel
blankDrawing=Tom ritning
blankDiagram=Blank diagram
block=Block
blockquote=Blockquote
bold=Fet
borderColor=Linjefärg
borderWidth=Linjebredd
bottom=Nedtill
bottomAlign=Justera nedtill
browser=Browser
bulletedList=Bulleted list
cancel=Avbryt
center=Centrera
cannotLoad=Kunde inte ladda, försök igen senare.
cannotLogin=Kunde inte logga in, försök igen senare.
changeOrientation=Ändra riktning
changeUser=Change user
changesNotSaved=Changes have not been saved
chatJoined={1} has joined
chatLeft={1} has left
chatWindowTitle=Chat
chooseAnOption=Choose an option
circle=Cirkel
classic=Klassisk
clipart=Clipart
close=Stäng
collaborator=Collaborator
collaborators=Collaborators
collapse=Minimera
collapse-expand=Minimera/Expandera
connect=Anslut
connecting=Ansluter
connectWithDrive=Anslut till Google Drive
connection=Anslutning
containsValidationErrors=Innehåller valideringsfel
copy=Kopiera
copyConnect=Kopera vid anslutning
copyOf=Copy of
copyOfDrawing=Kopia av ritning
create=Create
createNewDiagram=Create new diagram
curved=Böjd
custom=Anpassad
cut=Klipp ut
dashed=Streckad
delete=Ta bort
device=Device
diagramLocked=Diagram has been locked to prevent further data loss.
diamond=Romb
diamondThin=Romb (tunn)
didYouKnow=Visste du att…
direction=Riktning
disconnected=Your session has expired. Please refresh the browser window.
done=Klar
doubleClickOrientation=Dubbelklicka för att ändra riktning
downloadAs=Download as
drawing=Ritning{1}
drawingEmpty=Ritningen är tom
drawingTooLarge=Ritningen är för stor
dropbox=Dropbox
duplicate=Duplicera
east=Öster
edit=Redigera
editData=Edit data
editImage=Edit image
editImageUrl=Edit Image URL
editLink=Redigera länk
editText=Edit text
googleImages=Google Images
imageSearch=Image Search
embed=Infoga
embedNotice=Lägg till den här koden i slutet av sidan
enterGroup=Gå in i grupp
enterName=Enter name
enterPropertyName=Enter property name
enterValue=Ange värde
entityRelation=Enhetsrelation
error=Fel
errorLoadingFile=Kunde inte ladda filen
errorRenamingFile=Error renaming file.
errorRenamingFileNotFound=Error renaming file. File was not found.
errorRenamingFileForbidden=Error renaming file. Insufficient access rights.
errorSavingFile=Kunde inte spara filen
errorSavingFileUnknown=Error authorizing with Google's servers. Please refresh the page to re-attempt.
errorSavingFileForbidden=Error saving file. Insufficient access rights.
errorSavingFileNotFound=Error saving file. File was not found.
exitGroup=Gå ut ur grupp
expand=Expandera
export=Exportera
failedToSaveTryReconnect=Kunde inte spara, försöker ansluta igen
featureRequest=Önskemål om ny funktion 
feedback=Feedback
file=Arkiv
filename=Filnamn
fileExists=File already exists
fileNotFound=Kunde inte hitta filen
fileNotFoundOrDenied=The file was not found. It does not exist or you do not have read access.
fileNotLoaded=Kunde inte ladda filen
fileNotSaved=Kunde inte spara filen
fileOpenLocation=Hur fil du öppna de här filerna?
fileWillBeSavedInAppFolder={1} will be saved in the app folder.
fillColor=Fyllningsfärg
fit=Anpassa
fitPage=Anpassa till sidan
fitPageWidth=Anpassa till sidbredden
fitWindow=Anpassa till fönstret
flipH=Vänd horisontellt
flipV=Vänd vertikalt
fontColor=Textfärg
fontFamily=Typsnitt
fontSize=Textstorlek
forbidden=You are not authorized to access this file
format=Format
formatted=Formatted
formattedText=Formatted text
forum=Diskussion/Hjälpforum
fromTemplate=Från mall
fromText=Från text
general=Allmänt
global=Global
googleDrive=Google Drive
gradient=Övertoning
gradientColor=Färg
grid=Rutnät
group=Gruppera
guides=Stödlinjer
hateApp=Jag hatar draw.io
heading=Heading
height=Höjd
help=Hjälp
helpTranslate=Hjälp oss översätta det här programmet
hide=Göm
hideIt=Hide {1}
hidden=Hidden
home=Hem
horizontal=Horisontell
horizontalFlow=Horisontellt flöde
horizontalTree=Horisontellt träd
html=HTML
htmlText=HTML text
image=Bild
images=Bilder
import=Importera
increaseIndent=Increase indent
decreaseIndent=Descrease indent
inline=På rad
insert=Insert
insertImage=Insert image
insertHorizontalRule=Insert horizontal rule
insertLink=Insert link
inserting=Inserting
invalidOrMissingFile=Felaktig eller saknad fil
italic=Kursiv
layer=Layer
layers=Layers
landscape=Landskap
language=Språk
lastChange=Last change {1} ago
lessThanAMinute=less than a minute
minute=minute
minutes=minutes
hours=hours
days=days
months=months
years=years
restartForChangeRequired=Changes will take effect after page refresh.
layout=Layout
left=Vänster
leftAlign=Vänsterjustera
line=Linje
lineend=Linjens slut
linestart=Linjens början
linewidth=Linjebredd
link=Link
loading=Laddar
lockUnlock=Lock/Unlock
loveApp=Jag älskar draw.io
makeCopy=Make a copy
manual=Manual
middle=Mitten
more=More
moreResults=Fler resultat
moreShapes=Fler former
move=Flytta
moveToFolder=Move to folder
moving=Moving
moveSelectionTo=Move selection to {1}
navigation=Navigering
new=Ny
noColor=Ingen färg
noFiles=Inga filer
noMoreResults=Inga fler resultat
none=Ingen
noOtherViewers=No other viewers
noPlugins=No plugins
noResultsFor=Inga resultat för  '{1}'
normal=Normal
north=Norr
notConnected=Inte ansluten
note=Note
notUsingService=Not using {1}?
numberedList=Numbered list
ok=OK
opacity=Opacitet
open=Öppna
openArrow=Öppen pil
openExistingDiagram=Open existing diagram
openFile=Öppna fil
openLink=Öppna länk
openInNewWindow=Öppna i nytt fönster
openIt=Open {1}
openSupported=Formatet som stöds är .XML-filer som sparats från det här programmet
options=Alternativ
organic=Organisk
orthogonal=Vinkelrät
otherViewer=other viewer
otherViewers=other viewers
oval=Oval
pages=Sidor
pageView=Sidvisning
pageSetup=Sidinställningar
pageScale=Sidskala
pan=Panorering
paperSize=Pappersformat
paste=Klistra in
perimeter=Omkrets
plain=Enkel
blue=Blue
green=Green
gray=Gray
turquoise=Turquoise
yellow=Yellow
red=Red
pink=Pink
purple=Purple
plugins=Plugins
pluginUrl=Plugin URL
pluginWarning=The page has requested to load the following plugin(s):\n \n {1}\n \n Would you like to load these plugin(s) now?\n \n NOTE : Only allow plugins to run if you fully understand the security implications of doing so.\n
portrait=Portrait
position=Position
posterPrint=Affischutskrift
preferences=Preferenser
preview=Förhandsgranska
print=Skriv ut
readOnly=Read-only
reconnecting=Återansluter
redirectToPro=This file was created in draw.io pro. You will be redirected now.
convertToPro=The file will be converted for draw.io pro now.
redo=Gör om
refresh=Refresh
rememberMe=Remember me
rememberThisSetting=Remember this setting
removeFormat=Clear formatting
removeFromGroup=Ta bort från grupp
removeIt=Remove {1}
removeWaypoint=Remove waypoint
rename=Rename
renamed=Renamed
renameIt=Rename {1}
renaming=Renaming
replace={1} finns redan. Vill du ersätta den?
replaceExistingDrawing=Ersätt befintlig ritning
reset=Återställ
resize=Ändra storlek
retryingIn=Försöker igen om {1} sekunder
retryingLoad=Kunde inte ladda, försöker igen…
retryingLogin=Det tog för lång tid att logga in, försöker igen…
right=Höger
rightAlign=Högerjustera
rotate=Rotera
rotation=Rotering
rounded=Rundad
save=Spara
saveAs=Spara som
saved=Sparad
saveDiagramsTo=Save diagrams to
saving=Sparar
scrollbars=Rullningslister
search=Sök
selectAll=Markera allt
selectEdges=Markera kanter
selectFont=Välj typsnitt
selectVertices=Markera hörn
sendMessage=Send
sessionTimeoutOnSave=Du har loggats ut från Google Drive på grund av inaktivitet. Klicka på OK för att logga in och spara.
setAsDefaultEdge=Använd som förvald kant
shadow=Skugga
shape=Form
shapes=Фormer
share=Dela
shareLink=Länk för delad redigering
sharingServerNotice=Tänk på att det här är en experimentell funktion, använd den på egen risk!
sharingServerReady=Delningsservern är redo.
sharingServerUnavailable=Delningsservern är inte tillgänglig.
signOut=Logga ut
size=Storlek
sourceSpacing=Källavstånd
south=Söder
spacing=Avstånd
specialLink=Special link
starting=Starting
straight=Rak
strokeColor=Linjefärg
style=Stil
subscript=Subscript
superscript=Superscript
support=Support
targetSpacing=Målavstånd
template=Template
text=Text
textAlignment=Textjustering
textOpacity=Textopacitet
tilt=Tilt
timeout=Timeout
toBack=Lägg underst
toFront=Lägg överst
tooltips=Verktygstips
top=Överst
topAlign=Justera upptill
transparent=Genomskinlig
underline=Understruken
undo=Ångra
ungroup=Dela upp
unsavedChanges=Unsaved changes
untitledDiagram=Untitled Diagram
unknownError=Unknown error
updatingDocument=Uppdaterar dokumentet, vänligen vänta…
updatingSelection=Uppdaterar markeringen, vänligen vänta…
url=URL
vertical=Vertikal
verticalFlow=Vertikalt flöde
verticalTree=Vertikalt träd
view=Innehåll
west=Väster
width=Bredd
wordWrap=Radbrytning
zoom=Zooma
zoomIn=Zooma in
zoomOut=Zooma ut
