# *DO NOT DIRECTLY EDIT THIS FILE, IT IS AUTOMATICALLY GENERATED AND IT IS BASED ON:*
# https://docs.google.com/spreadsheet/ccc?key=0AmQEO36liL4FdDJLWVNMaVV2UmRKSnpXU09MYkdGbEE
aboutDrawio=draw.ioについて
access_denied=アクセスが拒否されました
actualSize=実寸
add=追加
addLayer=レイヤーを追加
addProperty=Add property
addToExistingDrawing=既存の図面に追加
addWaypoint=「途中点」を追加
align=配置指定
alignment=列
allChangesLost=すべての変更が失われます!
areYouSure=Are you sure?
ensureDataSaved=Please ensure your data is saved before closing.
allChangesSaved=All changes saved
allChangesSavedInDrive=All changes saved in Drive
allowPopups=Allow pop-ups to avoid this dialog.
alreadyConnected=ノードがすでに接続されています
apply=適応
arrange=調整
appNotInstalledAlert=アプリケーションがインストールされていません。Chromeウェブストアからdraw.ioをインストールし、再試行してください。
appNotInstalledStatus=アプリケーションがインストールされていません。
arrow=矢印
arrows=矢印
authorizationRequired=Authorization required
authorizeThisAppIn=Authorize this app in {1}:
authorize=Authorize
authorizing=Authorizing
automatic=自動
autosave=Autosave
autosize=自動サイズ
background=バックグラウンド
backgroundColor=背景色
basic=基本
blankDrawing=空白に描く
blankDiagram=Blank diagram
block=ブロック
blockquote=Blockquote
bold=太字
borderColor=罫線の色
borderWidth=枠線の太さ
bottom=下付き
bottomAlign=下付き
browser=Browser
bulletedList=Bulleted list
cancel=キャンセル
center=中央寄せする
cannotLoad=ロードは失敗しました。後ほど再びご確認下さい。
cannotLogin=ログインは失敗しました。後ほど再びご確認下さい。
changeOrientation=向きを変更
changeUser=Change user
changesNotSaved=Changes have not been saved
chatJoined={1} がチャットに参加されました。
chatLeft={1} がチャットを去りました。
chatWindowTitle=チャット
chooseAnOption=Choose an option
circle=円形
classic=クラシック
clipart=クリップアート
close=終了する
collaborator=Collaborator
collaborators=Collaborators
collapse=閉じる
collapse-expand=縮小/拡大
connect=接続する
connecting=接続中
connectWithDrive=Googleドライブに接続
connection=接続
containsValidationErrors=検証エラーがあります
copy=コピー
copyConnect=接続時にコピー
copyOf=Copy of
copyOfDrawing=図をコピー
create=Create
createNewDiagram=Create new diagram
curved=カーブ
custom=カスタム
cut=切り取り
dashed=破線
delete=削除
device=Device
diagramLocked=Diagram has been locked to prevent further data loss.
diamond=ダイヤモンド
diamondThin=ダイヤモンド（細）
didYouKnow=ご存知ですか・・・
direction=方向
disconnected=Your session has expired. Please refresh the browser window.
done=完了
doubleClickOrientation=ダブルクリックして向きを変更
downloadAs=Download as
drawing=描画{1}
drawingEmpty=描画状態は空白です
drawingTooLarge=描画が大きすぎます
dropbox=Dropbox
duplicate=コピーを作成
east=東
edit=編集
editData=Edit data
editImage=Edit image
editImageUrl=Edit Image URL
editLink=編集リンク
editText=Edit text
googleImages=Google Images
imageSearch=Image Search
embed=埋め込み
embedNotice=ページの最後にこのコードを埋め込んでください
enterGroup=グループに入れる
enterName=名を入力
enterPropertyName=Enter property name
enterValue=値を入力
entityRelation=ER
error=エラー
errorLoadingFile=ファイル読み込みエラー
errorRenamingFile=ファイルの名前変更失敗。
errorRenamingFileNotFound=ファイルの名前変更失敗。そのファイルが有りません。
errorRenamingFileForbidden=ファイルの名前変更失敗。十分な検眼が有りません。
errorSavingFile=ファイル保存エラー
errorSavingFileUnknown=Error authorizing with Google's servers. Please refresh the page to re-attempt.
errorSavingFileForbidden=ファイル保存エラー。アクセス権が不十分。
errorSavingFileNotFound=ファイル保存エラー。ファイルが見つかりません。
exitGroup=グループから出る
expand=拡大
export=エクスポート
failedToSaveTryReconnect=保存に失敗しました。再接続中です。
featureRequest=機能追加のご依頼
feedback=フィードバック
file=ファイル
filename=ファイル名
fileExists=File already exists
fileNotFound=ファイルが見つかりません
fileNotFoundOrDenied=The file was not found. It does not exist or you do not have read access.
fileNotLoaded=ファイルが読み込まれません
fileNotSaved=ファイルが保存されていません
fileOpenLocation=このファイルはどのように開きますか？
fileWillBeSavedInAppFolder={1} will be saved in the app folder.
fillColor=塗りつぶしの色
fit=フィット
fitPage=ページ全体表示
fitPageWidth=ページ幅
fitWindow=ウィンドウに合わせる
flipH=水平方向に反転
flipV=縦方向に反転
fontColor=フォントの色
fontFamily=フォントの種類
fontSize=フォントサイズ
forbidden=You are not authorized to access this file
format=形式
formatted=Formatted
formattedText=Formatted text
forum=ヘルプ・ディスカッション 
fromTemplate=テンプレートから
fromText=テキストから
general=一般
global=グローバル
googleDrive=Google Drive
gradient=グラデーション
gradientColor=色
grid=グリッド
group=グループ化
guides=ガイド
hateApp=draw.ioなんか大嫌い！
heading=Heading
height=縦幅
help=ヘルプ
helpTranslate=このアプリケーションの翻訳お手伝いをしてください
hide=非表示
hideIt={1}を隠す
hidden=隠された
home=ホーム
horizontal=水平
horizontalFlow=フロー図
horizontalTree=横ツリー図
html=HTML
htmlText=HTML text
image=イメージ
images=イメージ
import=インポート
increaseIndent=Increase indent
decreaseIndent=Descrease indent
inline=インライン
insert=Insert
insertImage=Insert image
insertHorizontalRule=Insert horizontal rule
insertLink=Insert link
inserting=Inserting
invalidOrMissingFile=無効または不明なファイル
italic=斜体
layer=レイヤー
layers=レイヤー
landscape=横向き
language=言語
lastChange=Last change {1} ago
lessThanAMinute=less than a minute
minute=minute
minutes=minutes
hours=hours
days=days
months=months
years=years
restartForChangeRequired=ページを更新しますと変更が有効になります。
layout=レイアウト
left=左端
leftAlign=左端
line=線
lineend=行の終了
linestart=行の開始
linewidth=線幅
link=Link
loading=読み込み中
lockUnlock=ロック設定／解除
loveApp=draw.io大好きだよ！
makeCopy=Make a copy
manual=マニュアル
middle=中央
more=More
moreResults=他の結果
moreShapes=他の図形
move=移動
moveToFolder=Move to folder
moving=Moving
moveSelectionTo=選択 {1} に移動する
navigation=ナビゲーション
new=新規作成
noColor=色なし
noFiles=ファイルなし
noMoreResults=結果は以上です
none=なし
noOtherViewers=No other viewers
noPlugins=プラグインがない
noResultsFor={1}'での検索結果はありません
normal=Normal
north=北
notConnected=接続されていません
note=Note
notUsingService=Not using {1}?
numberedList=Numbered list
ok=OK
opacity=不透明度
open=開く
openArrow=開いた矢印
openExistingDiagram=Open existing diagram
openFile=ファイルを開く
openLink=リンクを開く
openInNewWindow=新しいウィンドウで開く
openIt=Open {1}
openSupported=このソフトを使って保存された.XMLフォーマットのファイルのみ開くことが出来ます。
options=オプション
organic=オーガニック
orthogonal=直交
otherViewer=other viewer
otherViewers=other viewers
oval=楕円
pages=ページ
pageView=ページのレイアウト
pageSetup=ページ設定
pageScale=ページスケール
pan=パニング
paperSize=用紙サイズ
paste=貼り付け
perimeter=境界
plain=プレーン
blue=Blue
green=Green
gray=Gray
turquoise=Turquoise
yellow=Yellow
red=Red
pink=Pink
purple=Purple
plugins=プラグイン
pluginUrl=プラグインのURL
pluginWarning=このページが下記のプラグインをロードしようとしています:\n \n {1}\n \n 今このプラグインをロードしますか？\n \n 注意: プラグインのセキュリティーの影響が解る場合のみ、ロードしてください。\n
portrait=Portrait
position=位置
posterPrint=ポスター印刷
preferences=嗜好
preview=印刷プレビュー
print=印刷
readOnly=読み取り専用
reconnecting=再接続中
redirectToPro=This file was created in draw.io pro. You will be redirected now.
convertToPro=The file will be converted for draw.io pro now.
redo=やり直し
refresh=Refresh
rememberMe=Remember me
rememberThisSetting=Remember this setting
removeFormat=Clear formatting
removeFromGroup=グループから削除
removeIt={1}  を削除。
removeWaypoint=「途中点」を削除
rename=名前変更
renamed=名前変更されました
renameIt={1}  の名前を変更する。
renaming=名前変更中
replace={1}はすでに存在します。上書きしますか？
replaceExistingDrawing=既存の図を上書きします
reset=リセット
resize=サイズ変更
retryingIn={1}秒後に再試行する。
retryingLoad=ロードが失敗しました。再試行中。
retryingLogin=ログインがタイムアウトしました。再試行中。
right=右端
rightAlign=右端
rotate=回転
rotation=回転
rounded=角丸
save=保存
saveAs=名前を付けて保存
saved=保存済み
saveDiagramsTo=Save diagrams to
saving=保存中
scrollbars=スクロール・バー
search=検索
selectAll=全ての選択
selectEdges=エッジを選択
selectFont=フォントの選択
selectVertices=頂点を選択
sendMessage=送信
sessionTimeoutOnSave=セッションがタイムアウトして、Googleドライブから切断されました。ログインして保存するには、OKをクリックしてください。
setAsDefaultEdge=デフォルトエッジとして設定
shadow=影付き
shape=図形
shapes=シェイプ
share=共有
shareLink=共同編集へのリンク
sharingServerNotice=注意事項：試験的な機能です。ユーザーの責任でご使用ください。
sharingServerReady=共有サーバーは準備完了です。
sharingServerUnavailable=共有サーバーが使用できません。
signOut=サインアウト
size=サイズ
sourceSpacing=元の空白
south=南
spacing=スペース
specialLink=Special link
starting=Starting
straight=直線
strokeColor=線の色
style=スタイル
subscript=Subscript
superscript=Superscript
support=サポート
targetSpacing=ターゲットの空白
template=Template
text=テキスト
textAlignment=テキストの位置
textOpacity=テキストの不透明度
tilt=９０度回転
timeout=Timeout
toBack=後ろへ
toFront=前へ
tooltips=ツール・チップ
top=上付き
topAlign=上付き
transparent=透明
underline=下線
undo=元に戻す
ungroup=グループ解除
unsavedChanges=Unsaved changes
untitledDiagram=Untitled Diagram
unknownError=Unknown error
updatingDocument=文書の更新中。しばらくお待ちください...
updatingSelection=選択の更新中。しばらくお待ちください...
url=URL
vertical=垂直
verticalFlow=縦向きフロー
verticalTree=縦ツリー図
view=表示
west=西
width=横幅
wordWrap=ワードラップ
zoom=拡大
zoomIn=ズームイン
zoomOut=ズームアウト
