# *DO NOT DIRECTLY EDIT THIS FILE, IT IS AUTOMATICALLY GENERATED AND IT IS BASED ON:*
# https://docs.google.com/spreadsheet/ccc?key=0AmQEO36liL4FdDJLWVNMaVV2UmRKSnpXU09MYkdGbEE
aboutDrawio=Draw.io névjegy
access_denied=Hozzáférés megtagadva
actualSize=Aktuális méret
add=Add
addLayer=Add layer
addProperty=Add property
addToExistingDrawing=Add hozzá a meglévő rajzhoz
addWaypoint=Add waypoint
align=Igazít
alignment=Igazítás
allChangesLost=Elvesz minden változtatás!
areYouSure=Are you sure?
ensureDataSaved=Please ensure your data is saved before closing.
allChangesSaved=All changes saved
allChangesSavedInDrive=All changes saved in Drive
allowPopups=Allow pop-ups to avoid this dialog.
alreadyConnected=A csomók már összekapcsoltak
apply=Alkalmaz
arrange=Elrendezés
appNotInstalledAlert=Az aplikáció nem lett telepítve. Kérem telepítse a Diagram.ly-t a Chrome Web Store-ban és próbálja újra.
appNotInstalledStatus=Az aplikáció nem lett telepítve.
arrow=Nyíl
arrows=Nyilak
authorizationRequired=Authorization required
authorizeThisAppIn=Authorize this app in {1}:
authorize=Authorize
authorizing=Authorizing
automatic=Automatic
autosave=Autosave
autosize=Automatikus méret
background=Background
backgroundColor=Háttérszín
basic=Alapvető
blankDrawing=Üres rajz
blankDiagram=Blank diagram
block=Blokk
blockquote=Blockquote
bold=Félkövér
borderColor=Keretszín
borderWidth=Keret vastagság
bottom=Alsó
bottomAlign=Alsó igazítás
browser=Browser
bulletedList=Bulleted list
cancel=Töröl
center=Közép
cannotLoad=A betöltési próbálkozások sikertelenek. Kérjük próbálja ismét kesőbb...
cannotLogin=A bejelentkezési próbálkozások sikertelenek. Kérjük próbálja ismét később...
changeOrientation=Irányultságváltoztatás
changeUser=Change user
changesNotSaved=Changes have not been saved
chatJoined={1} has joined
chatLeft={1} has left
chatWindowTitle=Chat
chooseAnOption=Choose an option
circle=Kör
classic=Klasszikus
clipart=Felhasználható grafikus elemek
close=Becsuk
collaborator=Collaborator
collaborators=Collaborators
collapse=Osszevon
collapse-expand=Összevon/Bővít
connect=Csatlakoztat
connecting=Csatlakoztatás
connectWithDrive=Csatlkakoztatás a Google Drive-val
connection=Kapcsolat
containsValidationErrors=Érvényesítési hibákat tartalmaz
copy=Másol
copyConnect=Másol kapcsoláskor
copyOf=Copy of
copyOfDrawing=Rajz másolás
create=Create
createNewDiagram=Create new diagram
curved=Curved
custom=Egyéni
cut=Vágj
dashed=Szaggatott
delete=Töröl
device=Device
diagramLocked=Diagram has been locked to prevent further data loss.
diamond=Rombusz
diamondThin=Rombusz (vékony)
didYouKnow=Tudta-e...
direction=Irány
disconnected=Your session has expired. Please refresh the browser window.
done=Befejez
doubleClickOrientation=Dupla klikk az irányultság változtatásához
downloadAs=Download as
drawing=Rajz{1}
drawingEmpty=A rajz üres
drawingTooLarge=A rajz túl nagy
dropbox=Dropbox
duplicate=Duplikát
east=Kelet
edit=Szerkeszt
editData=Edit data
editImage=Edit image
editImageUrl=Edit Image URL
editLink=Linket szerkeszt
editText=Edit text
googleImages=Google Images
imageSearch=Image Search
embed=Beágyaz
embedNotice=Egyszer hozzáadja ezt az oldal végére
enterGroup=Csoportba be
enterName=Enter name
enterPropertyName=Enter property name
enterValue=Érték betáplálása
entityRelation=Egyedkapcsolat
error=Hiba
errorLoadingFile=Hiba a fájl betáplálásakor
errorRenamingFile=Error renaming file.
errorRenamingFileNotFound=Error renaming file. File was not found.
errorRenamingFileForbidden=Error renaming file. Insufficient access rights.
errorSavingFile=Hiba a fájl mentésekor
errorSavingFileUnknown=Error authorizing with Google's servers. Please refresh the page to re-attempt.
errorSavingFileForbidden=Error saving file. Insufficient access rights.
errorSavingFileNotFound=Error saving file. File was not found.
exitGroup=Csoportból kilép
expand=Bővít
export=Exportálás
failedToSaveTryReconnect=Sikertelen mentés, próbáljon újrakapcsolódni
featureRequest=Sajátosságok kérelmez
feedback=Visszajelzés
file=Fájl
filename=Fájlnév
fileExists=File already exists
fileNotFound=Fájl nem található
fileNotFoundOrDenied=The file was not found. It does not exist or you do not have read access.
fileNotLoaded=Fájl nincs betöltve
fileNotSaved=Fájl nincs mentve
fileOpenLocation=Hogyan szeretné nyitni ezt a fájlt?
fileWillBeSavedInAppFolder={1} will be saved in the app folder.
fillColor=Kitöltés szín
fit=Illeszt
fitPage=Oldalmérethez méretezett
fitPageWidth=Oldalszélességhez alakít
fitWindow=Ablakhoz méretezett
flipH=Vízszintesen tükröz
flipV=Merőlegesen tükröz
fontColor=Betűkészlet szín
fontFamily=Betűcsalád
fontSize=Betűméret
forbidden=You are not authorized to access this file
format=Formátum
formatted=Formatted
formattedText=Formatted text
forum=Fórum
fromTemplate=Sablonból
fromText=Szövegből
general=Általános
global=Globális
googleDrive=Google Drive
gradient=Gradiens
gradientColor=Gradiens szín
grid=Hálózat
group=Csoportosít
guides=Vezetők
hateApp=Utálom a draw.io-t
heading=Heading
height=Magasság
help=Súgó
helpTranslate=Segítsen a program fordításában
hide=Elrejt
hideIt=Hide {1}
hidden=Hidden
home=Otthon
horizontal=Vízszintes
horizontalFlow=Vízszintes folyam
horizontalTree=Függőleges fa
html=HTML
htmlText=HTML text
image=Kép
images=Képek
import=Importál
increaseIndent=Increase indent
decreaseIndent=Descrease indent
inline=Beépített
insert=Insert
insertImage=Insert image
insertHorizontalRule=Insert horizontal rule
insertLink=Insert link
inserting=Inserting
invalidOrMissingFile=Érvénytelen vagy hiányzó fájl
italic=Dőlt
layer=Layer
layers=Layers
landscape=Fekvő lap
language=Nyelv
lastChange=Last change {1} ago
lessThanAMinute=less than a minute
minute=minute
minutes=minutes
hours=hours
days=days
months=months
years=years
restartForChangeRequired=Changes will take effect after page refresh.
layout=Elrendezés
left=Bal
leftAlign=Bal igazítás
line=Vonal
lineend=Vonalvég
linestart=Vonalkezdet
linewidth=Vonalvastagság
link=Link
loading=Betöltés
lockUnlock=Lock/Unlock
loveApp=Tetszik a draw.io
makeCopy=Make a copy
manual=Manual
middle=Közép
more=More
moreResults=Több eredmény
moreShapes=Több alakzat
move=Mozgat
moveToFolder=Move to folder
moving=Moving
moveSelectionTo=Move selection to {1}
navigation=Navigáció
new=Új
noColor=Szín nélkül
noFiles=Fájlok nélkül
noMoreResults=Nincs több eredmény
none=Semmi
noOtherViewers=No other viewers
noPlugins=No plugins
noResultsFor=Nincs eredmény a {1}-hez
normal=Normal
north=Észak
notConnected=Nincs csatlakoztatva
note=Note
notUsingService=Not using {1}?
numberedList=Numbered list
ok=OK
opacity=Fedőképesség
open=Kinyit
openArrow=Nyitott nyíl
openExistingDiagram=Open existing diagram
openFile=Fájlt kinyit
openLink=Linket nyit
openInNewWindow=Új ablakban nyit
openIt=Open {1}
openSupported=A támogatott formátum .XML fájlok ebből a programból mentve
options=Beállítások
organic=Szerves
orthogonal=Merőleges
otherViewer=other viewer
otherViewers=other viewers
oval=Ovális
pages=Oldalak
pageView=Oldal elrendezés
pageSetup=Oldal beállítás
pageScale=Oldal méretarány
pan=Pan
paperSize=Oldalméret
paste=Beilleszt
perimeter=Perem
plain=Egyszerű
blue=Blue
green=Green
gray=Gray
turquoise=Turquoise
yellow=Yellow
red=Red
pink=Pink
purple=Purple
plugins=Plugins
pluginUrl=Plugin URL
pluginWarning=The page has requested to load the following plugin(s):\n \n {1}\n \n Would you like to load these plugin(s) now?\n \n NOTE : Only allow plugins to run if you fully understand the security implications of doing so.\n
portrait=Portrait
position=Pozíció
posterPrint=Poszter nyomtatás
preferences=Beállítások
preview=Előnézet
print=Nyomtat
readOnly=Read-only
reconnecting=Újracsatlakoztatás
redirectToPro=This file was created in draw.io pro. You will be redirected now.
convertToPro=The file will be converted for draw.io pro now.
redo=Helyrehoz
refresh=Refresh
rememberMe=Remember me
rememberThisSetting=Remember this setting
removeFormat=Clear formatting
removeFromGroup=Eltávolítás a csoportból
removeIt=Remove {1}
removeWaypoint=Remove waypoint
rename=Rename
renamed=Renamed
renameIt=Rename {1}
renaming=Renaming
replace={1} már létezik. Helyettesíti?
replaceExistingDrawing=Helyettesiti a meglévő rajzot
reset=Újrakezd
resize=Atméretez
retryingIn=Újrapróbálkozás {1} másodperc múlva
retryingLoad=A betöltés sikertelen. Ujrapróbálkozás...
retryingLogin=A bejelentkezési idő lejárt. Újrapróbálkozás...
right=Jobb
rightAlign=Jobb igazítás
rotate=Forgat
rotation=Forgatás
rounded=Lekerekített
save=Mentés
saveAs=Mentés másként
saved=Mentett
saveDiagramsTo=Save diagrams to
saving=Mentés
scrollbars=Gördítősávok
search=Keresés
selectAll=Mindent kijelöl
selectEdges=Éleket kijelöl
selectFont=Betűkészlet választás
selectVertices=Csomók kijelölése
sendMessage=Send
sessionTimeoutOnSave=Az öm munkamenete ideje lejárt és szétkapcsolódott a Google Drive-tól. Nyomja meg az OK-t, hogy bejelentkezzen és mentse adatait.
setAsDefaultEdge=Alapértelmezett él bejelölése
shadow=Árnyék
shape=Alakzat
shapes=Alakzatok
share=Osztás
shareLink=Link osztása
sharingServerNotice=Megjegyzés: kisérleti eszköz. Saját felelősségre használja!
sharingServerReady=Osztási szerver kész
sharingServerUnavailable=Osztási szerver elérhetetlen
signOut=Kijelentkezés
size=Méret
sourceSpacing=Forrás térköz
south=Dél
spacing=Térköz
specialLink=Special link
starting=Starting
straight=Egyenes
strokeColor=Vonal szín
style=Stílus
subscript=Subscript
superscript=Superscript
support=Support
targetSpacing=Cél térköz
template=Template
text=Szöveg
textAlignment=Szöveg igazítása
textOpacity=Szöveg fedőképessége
tilt=Tilt
timeout=Timeout
toBack=Hátra küld
toFront=Előre hoz
tooltips=Helyi súgók
top=Felső
topAlign=Felső igazítás
transparent=Átlátszó
underline=Aláhúz
undo=Visszavon
ungroup=Szétválaszt
unsavedChanges=Unsaved changes
untitledDiagram=Untitled Diagram
unknownError=Unknown error
updatingDocument=Dokumentum frissítése. Kérem várjon...
updatingSelection=Kiválasztás frissítése. Kérem várjon...
url=URL
vertical=Merőleges
verticalFlow=Merőleges folyam
verticalTree=Merőleges fa
view=Nézet
west=Nyugat
width=Szélesség
wordWrap=Word wrap
zoom=Nagyitás
zoomIn=Megnagyít
zoomOut=Lekicsinyít
