# *DO NOT DIRECTLY EDIT THIS FILE, IT IS AUTOMATICALLY GENERATED AND IT IS BASED ON:*
# https://docs.google.com/spreadsheet/ccc?key=0AmQEO36liL4FdDJLWVNMaVV2UmRKSnpXU09MYkdGbEE
aboutDrawio=O draw.io
access_denied=Pristup odbijen
actualSize=Prirodna veličina
add=Add
addLayer=Add layer
addProperty=Add property
addToExistingDrawing=Dodaj na postojeći crtež
addWaypoint=Add waypoint
align=Poravnaj
alignment=Poravnanje
allChangesLost=Sve promene će biti izgubljene!
areYouSure=Are you sure?
ensureDataSaved=Please ensure your data is saved before closing.
allChangesSaved=All changes saved
allChangesSavedInDrive=All changes saved in Drive
allowPopups=Allow pop-ups to avoid this dialog.
alreadyConnected=Čvorovi su već povezani
apply=Primeni
arrange=Složi
appNotInstalledAlert=Aplikacija nije instalirana. Molim vas instalirajte Diagram.ly u Chrome Web Store i pokušajte ponovo
appNotInstalledStatus=Aplikacija nije instalirana.
arrow=Strelica
arrows=Strelice
authorizationRequired=Authorization required
authorizeThisAppIn=Authorize this app in {1}:
authorize=Authorize
authorizing=Authorizing
automatic=Automatic
autosave=Autosave
autosize=Automatska veličina
background=Background
backgroundColor=Boja pozadine
basic=Osnovni
blankDrawing=Prazan crtež
blankDiagram=Blank diagram
block=Blok
blockquote=Blockquote
bold=Podebljano
borderColor=Boja okvira
borderWidth=Širina okvira
bottom=Dno
bottomAlign=Poravnanje pri dnu
browser=Browser
bulletedList=Bulleted list
cancel=Otkaži
center=Centar
cannotLoad=Pokušaji učitavanja neuspešni. Molimo vas pokušajte kasnije.
cannotLogin=Pokušaji logovanja neuspešni. Molimo vas pokušajte kasnije.
changeOrientation=Promeni orijentaciju
changeUser=Change user
changesNotSaved=Changes have not been saved
chatJoined={1} se pridružio
chatLeft={1} je otišao
chatWindowTitle=Chat
chooseAnOption=Choose an option
circle=Krug
classic=Klasičan
clipart=Klip art
close=Zatvori
collaborator=Collaborator
collaborators=Collaborators
collapse=Spusti
collapse-expand=Spusti/proširi
connect=Poveži
connecting=Povezivanje
connectWithDrive=Povezivanje sa Google Drive
connection=Veza
containsValidationErrors=Sadrži greške u validaciji
copy=Kopiraj
copyConnect=Kopiraj pri povezivanju
copyOf=Copy of
copyOfDrawing=Kopija crteža
create=Create
createNewDiagram=Create new diagram
curved=Zakrivljeno
custom=Posebno
cut=Iseci
dashed=Isprekidan
delete=Ukloni
device=Device
diagramLocked=Diagram has been locked to prevent further data loss.
diamond=Romb
diamondThin=Romb (tanak)
didYouKnow=Da li ste znali...
direction=Pravac
disconnected=Your session has expired. Please refresh the browser window.
done=Završeno
doubleClickOrientation=Dupli klik za promenu orijentacije
downloadAs=Download as
drawing=Crtež{1}
drawingEmpty=Crtež je prazan
drawingTooLarge=Crtež je prevelik
dropbox=Dropbox
duplicate=Duplikat
east=Istok
edit=Uredi
editData=Edit data
editImage=Edit image
editImageUrl=Edit Image URL
editLink=Uredi link
editText=Edit text
googleImages=Google Images
imageSearch=Image Search
embed=Ugradi
embedNotice=Ugradi ovo jednom pri kraju stranice
enterGroup=Uđi u grupu
enterName=Enter name
enterPropertyName=Enter property name
enterValue=Unesi vrednost
entityRelation=Relacija entiteta
error=Greška
errorLoadingFile=Greška pri učitavanju dokumenta
errorRenamingFile=Greška pri preimenovanju dokumenta
errorRenamingFileNotFound=Greška pri preimenovanju. Datoteka nije pronađena.
errorRenamingFileForbidden=Greška pri preimenovanju. Nedovoljna prava pristupa.
errorSavingFile=Greška pri snimanju dokumenta
errorSavingFileUnknown=Error authorizing with Google's servers. Please refresh the page to re-attempt.
errorSavingFileForbidden=Greška pri snimanju. Nedovoljna prava pristupa.
errorSavingFileNotFound=Greška pri snimanju. Datoteka nije pronađena.
exitGroup=Izađi iz grupe
expand=Razvij
export=Eksportuj
failedToSaveTryReconnect=Neuspelo snimanje, pokušaj rekonekcije
featureRequest=Zatraži odliku
feedback=Komentar
file=Datoteka
filename=Ime datoteke
fileExists=File already exists
fileNotFound=Datoteka nije pronađena
fileNotFoundOrDenied=The file was not found. It does not exist or you do not have read access.
fileNotLoaded=Datoteka nije učitana
fileNotSaved=Datoteka nije snimljena
fileOpenLocation=Kako biste želeli otvoriti ovaj dokument?
fileWillBeSavedInAppFolder={1} will be saved in the app folder.
fillColor=Boja popunjavanja
fit=Prilagodi
fitPage=Prilagodi stranici
fitPageWidth=Prilagodi širini stranice
fitWindow=Prilagodi prozoru
flipH=Preokreni vodoravno
flipV=Preokreni uspravno
fontColor=Boja fonta
fontFamily=Font
fontSize=Veličina slova
forbidden=You are not authorized to access this file
format=Format
formatted=Formatted
formattedText=Formatted text
forum=Forum
fromTemplate=Od šablona
fromText=Od teksta
general=Opšti
global=Globalan
googleDrive=Google Drive
gradient=Gradijent
gradientColor=Boja gradijenta
grid=Mreža
group=Grupiši
guides=Vodiči
hateApp=Mrzim draw.io
heading=Heading
height=Visina
help=Pomoć
helpTranslate=Pomozite nam u prevođenju ove aplikacije
hide=Sakrij
hideIt=Hide {1}
hidden=Hidden
home=Dom
horizontal=Vodoravan
horizontalFlow=Vodoravni tok
horizontalTree=Vodoravno drvo
html=HTML
htmlText=HTML text
image=Slika
images=Slike
import=Import
increaseIndent=Increase indent
decreaseIndent=Descrease indent
inline=Inline
insert=Insert
insertImage=Insert image
insertHorizontalRule=Insert horizontal rule
insertLink=Insert link
inserting=Inserting
invalidOrMissingFile=Neispravan ili nepostojeći dokument
italic=Kurziv
layer=Layer
layers=Layers
landscape=Pejzaž
language=Jezik
lastChange=Last change {1} ago
lessThanAMinute=less than a minute
minute=minute
minutes=minutes
hours=hours
days=days
months=months
years=years
restartForChangeRequired=Changes will take effect after page refresh.
layout=Raspored
left=Levo
leftAlign=Levo poravnanje
line=Linija
lineend=Kraj linije
linestart=Početak linije
linewidth=Debljina linije
link=Link
loading=Učitavanje
lockUnlock=Lock/Unlock
loveApp=Volim draw.io
makeCopy=Make a copy
manual=Ručno
middle=Sredina
more=More
moreResults=Još rezultata
moreShapes=Još oblika
move=Pomeri
moveToFolder=Move to folder
moving=Moving
moveSelectionTo=Move selection to {1}
navigation=Navigacija
new=Novi
noColor=Bez boje
noFiles=Nema fajlova
noMoreResults=Nema više rezultata
none=Ništa
noOtherViewers=No other viewers
noPlugins=No plugins
noResultsFor=Nema više rezultata za {1}
normal=Normal
north=Sever
notConnected=Bez konekcije
note=Note
notUsingService=Not using {1}?
numberedList=Numbered list
ok=OK
opacity=Prozirnost
open=Otvori
openArrow=Otvorena strelica
openExistingDiagram=Open existing diagram
openFile=Otvori datoteku
openLink=Otvori link
openInNewWindow=Otvori u novom prozoru
openIt=Open {1}
openSupported=Podržani format je .XML datoteka sačuvana iz ovog softvera
options=Opcije
organic=Organski
orthogonal=Pravougaoni
otherViewer=other viewer
otherViewers=other viewers
oval=Ovalan
pages=Stranice
pageView=Pregled strane
pageSetup=Podešavanje strane
pageScale=Razmera strane
pan=Pan
paperSize=Veličina papira
paste=Zalepi
perimeter=Perimetar
plain=Jednostavan
blue=Blue
green=Green
gray=Gray
turquoise=Turquoise
yellow=Yellow
red=Red
pink=Pink
purple=Purple
plugins=Plugins
pluginUrl=Plugin URL
pluginWarning=The page has requested to load the following plugin(s):\n \n {1}\n \n Would you like to load these plugin(s) now?\n \n NOTE : Only allow plugins to run if you fully understand the security implications of doing so.\n
portrait=Portrait
position=Pozicija
posterPrint=Štampa postera
preferences=Podešavanja
preview=Pregled
print=Štampa
readOnly=Samo čitanje
reconnecting=Rekonekcija
redirectToPro=This file was created in draw.io pro. You will be redirected now.
convertToPro=The file will be converted for draw.io pro now.
redo=Ponovi
refresh=Refresh
rememberMe=Remember me
rememberThisSetting=Remember this setting
removeFormat=Clear formatting
removeFromGroup=Ukloni iz grupe
removeIt=Remove {1}
removeWaypoint=Remove waypoint
rename=Preimenuj
renamed=Preimenovano
renameIt=Rename {1}
renaming=Preimenovanje
replace={1} već postoji. Da li želite da ga zamenite?
replaceExistingDrawing=Zameni postojeći crtež
reset=Reset
resize=Predimenzioniranje
retryingIn=Ponovni pokušaj za {1} sekundi
retryingLoad=Učitavanje neuspešno. Ponovni pokušaj...
retryingLogin=Vreme logovanja isteklo. Ponovni pokušaj...
right=Desno
rightAlign=Desno poravnanje
rotate=Rotiraj
rotation=Rotacija
rounded=Zaobljen
save=Snimi
saveAs=Snimi kao
saved=Snimljeno
saveDiagramsTo=Save diagrams to
saving=Snimanje
scrollbars=Skroltrake
search=Pretraga
selectAll=Izaberi sve
selectEdges=Izaberi grane
selectFont=Izaberi font
selectVertices=Izaberi čvorove
sendMessage=Pošalji
sessionTimeoutOnSave=Vaša sesija je istekla i odjavljeni ste sa Google Drive-a. Kliknite OK da se prijavite i snimite izmene.
setAsDefaultEdge=Postavi kao podrazumevanu granu
shadow=Senka
shape=Oblik
shapes=Shapes
share=Podeli
shareLink=Podeli link
sharingServerNotice=Pažnja: eksperimentalna funkcija. Upotreba na sopstvenu odgovornost!
sharingServerReady=Server za razmenu je spreman.
sharingServerUnavailable=Server za razmenu je nedostupan.
signOut=Odjavi se
size=Veličina
sourceSpacing=Proređivanje izvora
south=Jug
spacing=Proređivanje
specialLink=Special link
starting=Starting
straight=Pravo
strokeColor=Boja linije
style=Stil
subscript=Subscript
superscript=Superscript
support=Support
targetSpacing=Proređivanje odredišta
template=Template
text=Tekst
textAlignment=Poravnanje teksta
textOpacity=Neprozirnost teksta
tilt=Nagni
timeout=Timeout
toBack=Postavi iza
toFront=Postavi ispred
tooltips=Opisi alatki
top=Vrh
topAlign=Gornje poravnanje
transparent=Proziran
underline=Podvučen
undo=Opozovi
ungroup=Podeli
unsavedChanges=Unsaved changes
untitledDiagram=Untitled Diagram
unknownError=Unknown error
updatingDocument=Ažuriranje dokumenta. Molimo sačekajte...
updatingSelection=Ažuriranje selekcije. Molimo sačekajte...
url=URL
vertical=Uspravno
verticalFlow=Uspravni tok
verticalTree=Uspravno drvo
view=Pogled
west=Zapad
width=Širina
wordWrap=Word wrap
zoom=Uvećanje
zoomIn=Uvećaj
zoomOut=Umanji
