# *DO NOT DIRECTLY EDIT THIS FILE, IT IS AUTOMATICALLY GENERATED AND IT IS BASED ON:*
# https://docs.google.com/spreadsheet/ccc?key=0AmQEO36liL4FdDJLWVNMaVV2UmRKSnpXU09MYkdGbEE
aboutDrawio=draw.io hakkında
access_denied=Erişim engellendi
actualSize=Gerçek boyutu
add=Add
addLayer=Add layer
addProperty=Add property
addToExistingDrawing=Mevcut resime ekle
addWaypoint=Add waypoint
align=Aynı hizaya getir
alignment=Hizalama
allChangesLost=Bütün değişiklikler kaybedilecek!
areYouSure=Are you sure?
ensureDataSaved=Please ensure your data is saved before closing.
allChangesSaved=All changes saved
allChangesSavedInDrive=All changes saved in Drive
allowPopups=Allow pop-ups to avoid this dialog.
alreadyConnected=Düğümler zaten bağlı
apply=Uygula
arrange=Düzenle
appNotInstalledAlert=Uygulama yüklü değil. Lütfen draw.io'yu Chrome Web Mağazası'na yükleyin ve tekrar deneyin
appNotInstalledStatus=Uygulama yüklü değil
arrow=Ok
arrows=Oklar
authorizationRequired=Authorization required
authorizeThisAppIn=Authorize this app in {1}:
authorize=Authorize
authorizing=Authorizing
automatic=Automatic
autosave=Autosave
autosize=Otomatik boyutlandır
background=Background
backgroundColor=Arkaplan rengi
basic=Temel
blankDrawing=Boş resim
blankDiagram=Blank diagram
block=Engelle
blockquote=Blockquote
bold=Koyu
borderColor=Kenarlık rengi
borderWidth=Kenarlık genişliği
bottom=Alt hiza
bottomAlign=Altı hizala
browser=Browser
bulletedList=Bulleted list
cancel=İptal
center=Ortala
cannotLoad=Load attempts failed. Please try again later.
cannotLogin=Log in attempts failed. Please try again later.
changeOrientation=Sayfa yönünü değiştir
changeUser=Change user
changesNotSaved=Changes have not been saved
chatJoined={1} has joined
chatLeft={1} has left
chatWindowTitle=Chat
chooseAnOption=Choose an option
circle=Çember
classic=Klasik
clipart=Küçük resim
close=Kapat
collaborator=Collaborator
collaborators=Collaborators
collapse=Daralt
collapse-expand=Daralt/Genişlet
connect=Bağlan
connecting=Bağlanıyor
connectWithDrive=Connect with Google Drive
connection=Bağlantı
containsValidationErrors=Doğrulama hataları içeriyor
copy=Kopyala
copyConnect=Copy on connect
copyOf=Copy of
copyOfDrawing=Resmin Kopyası
create=Create
createNewDiagram=Create new diagram
curved=Curved
custom=Özel
cut=Kes
dashed=Kesik çizgili
delete=Sil
device=Device
diagramLocked=Diagram has been locked to prevent further data loss.
diamond=Elmas ok
diamondThin=Elmas ok (ince)
didYouKnow=Biliyor muydunuz...
direction=Yön
disconnected=Your session has expired. Please refresh the browser window.
done=Tamamlandı
doubleClickOrientation=Yönü değiştirmek için çift tıklayın
downloadAs=Download as
drawing=Resim{1}
drawingEmpty=Boş resim
drawingTooLarge=Resim çok büyük
dropbox=Dropbox
duplicate=Çoğalt
east=Doğu
edit=Düzenle
editData=Edit data
editImage=Edit image
editImageUrl=Edit Image URL
editLink=Bağlantıyı düzenle
editText=Edit text
googleImages=Google Images
imageSearch=Image Search
embed=Dahil et
embedNotice=Bunu sayfa sonuna ekleyin
enterGroup=Grup gir
enterName=Enter name
enterPropertyName=Enter property name
enterValue=Değer gir
entityRelation=Varlık bağlantısı
error=Hata
errorLoadingFile=Dosya yükleme hatası
errorRenamingFile=Error renaming file.
errorRenamingFileNotFound=Error renaming file. File was not found.
errorRenamingFileForbidden=Error renaming file. Insufficient access rights.
errorSavingFile=Dosya kayıt hatası
errorSavingFileUnknown=Error authorizing with Google's servers. Please refresh the page to re-attempt.
errorSavingFileForbidden=Error saving file. Insufficient access rights.
errorSavingFileNotFound=Error saving file. File was not found.
exitGroup=Gruptan çık
expand=Genişlet
export=Dışa aktar
failedToSaveTryReconnect=Kaydetme başarısız, tekrar bağlanmayı deniyor
featureRequest=Feature Request
feedback=Feedback
file=Dosya
filename=Dosya adı
fileExists=File already exists
fileNotFound=Dosya bulunamadı
fileNotFoundOrDenied=The file was not found. It does not exist or you do not have read access.
fileNotLoaded=Dosya yüklenemedi
fileNotSaved=Dosya kaydedilemedi
fileOpenLocation=How would you like to open these file(s)?
fileWillBeSavedInAppFolder={1} will be saved in the app folder.
fillColor=Dolgu rengi
fit=Sığdır
fitPage=Sayfaya sığdır
fitPageWidth=Sayfa genişliğine sığdır
fitWindow=Pencereye sığdır
flipH=Yatay çevir
flipV=Dikey çevir
fontColor=Yazı tipi rengi
fontFamily=Yazı tipi
fontSize=Yazı boyutu
forbidden=You are not authorized to access this file
format=Format
formatted=Formatted
formattedText=Formatted text
forum=Tartışma/Yardım Forumları
fromTemplate=Şablondan
fromText=Metinden
general=Genel
global=Global
googleDrive=Google Drive
gradient=Gradyan
gradientColor=Renk
grid=Kılavuz
group=Grupla
guides=Rehberler
hateApp=I hate draw.io
heading=Heading
height=Yükseklik
help=Yardım
helpTranslate=Bu uygulamayı tercümede bize yardım edin
hide=Gizle
hideIt=Hide {1}
hidden=Hidden
home=Anasayfa
horizontal=Yatay
horizontalFlow=Yatay akış
horizontalTree=Yatay şema
html=HTML
htmlText=HTML text
image=Görsel
images=Görseller
import=İçe aktar
increaseIndent=Increase indent
decreaseIndent=Descrease indent
inline=Satır içi
insert=Insert
insertImage=Insert image
insertHorizontalRule=Insert horizontal rule
insertLink=Insert link
inserting=Inserting
invalidOrMissingFile=Hatalı veya eksik dosya
italic=İtalik
layer=Layer
layers=Layers
landscape=Manzara
language=Dil
lastChange=Last change {1} ago
lessThanAMinute=less than a minute
minute=minute
minutes=minutes
hours=hours
days=days
months=months
years=years
restartForChangeRequired=Changes will take effect after page refresh.
layout=Düzen
left=Sol
leftAlign=Sola hizala
line=Çizgi
lineend=Çizgi sonu
linestart=Çizgi başı
linewidth=Çizgi genişliği
link=Link
loading=Yüklüyor
lockUnlock=Lock/Unlock
loveApp=I love draw.io
makeCopy=Make a copy
manual=Manual
middle=Orta
more=More
moreResults=Daha fazla sonuç
moreShapes=Daha fazla şekil
move=Taşı
moveToFolder=Move to folder
moving=Moving
moveSelectionTo=Move selection to {1}
navigation=Navigasyon
new=Yeni
noColor=Renk yok
noFiles=Dosya yok
noMoreResults=Görüntülenecek başka sonuç yok
none=Hiçbiri
noOtherViewers=No other viewers
noPlugins=No plugins
noResultsFor={1}' için sonuç yok
normal=Normal
north=Kuzey
notConnected=Bağlı değil
note=Note
notUsingService=Not using {1}?
numberedList=Numbered list
ok=Tamam
opacity=Bulanıklık
open=Aç
openArrow=Açık ok
openExistingDiagram=Open existing diagram
openFile=Dosyayı aç
openLink=Bağlantıyı aç
openInNewWindow=Yeni pencerede aç
openIt=Open {1}
openSupported=Bu yazılıma ait desteklenen dosya formatı .XLS'tir
options=Seçenekler
organic=Organik
orthogonal=Dikgen
otherViewer=other viewer
otherViewers=other viewers
oval=Oval
pages=Sayfalar
pageView=Sayfa görünümü
pageSetup=Sayfa ayarı
pageScale=Sayfa ölçeği
pan=Kaydır
paperSize=Kağıt boyutu
paste=Yapıştır
perimeter=Çevresi
plain=Düz
blue=Blue
green=Green
gray=Gray
turquoise=Turquoise
yellow=Yellow
red=Red
pink=Pink
purple=Purple
plugins=Plugins
pluginUrl=Plugin URL
pluginWarning=The page has requested to load the following plugin(s):\n \n {1}\n \n Would you like to load these plugin(s) now?\n \n NOTE : Only allow plugins to run if you fully understand the security implications of doing so.\n
portrait=Portrait
position=Konum
posterPrint=Poster baskı
preferences=Tercihleri
preview=Ön izleme
print=Yazdır
readOnly=Read-only
reconnecting=Yeniden bağlanıyor
redirectToPro=This file was created in draw.io pro. You will be redirected now.
convertToPro=The file will be converted for draw.io pro now.
redo=Yinele
refresh=Refresh
rememberMe=Remember me
rememberThisSetting=Remember this setting
removeFormat=Clear formatting
removeFromGroup=Gruptan çıkart
removeIt=Remove {1}
removeWaypoint=Remove waypoint
rename=Rename
renamed=Renamed
renameIt=Rename {1}
renaming=Renaming
replace={1} zaten bulunuyor. Değiştirmek istiyor musunuz?
replaceExistingDrawing=Mevcut resmi değiştirin
reset=Sıfırla
resize=Yeniden boyutlandır
retryingIn=Retrying in {1} second(s)
retryingLoad=Load failed. Retrying...
retryingLogin=Login time out. Retrying...
right=Sağ
rightAlign=Sağa hizala
rotate=Döndür
rotation=Döndürmek
rounded=Yuvarlanmış
save=Kaydet
saveAs=Farklı kaydet
saved=Kaydedildi
saveDiagramsTo=Save diagrams to
saving=Kaydediliyor
scrollbars=Kaydırma çubuğu
search=Ara
selectAll=Tümünü seç
selectEdges=Kenarları seç
selectFont=Bir yazı tipi seç
selectVertices=Köşeleri seç
sendMessage=Send
sessionTimeoutOnSave=Your session has timed out and you have been disconnected from the Google Drive. Press OK to login and save. 
setAsDefaultEdge=Varsayılan köşe olarak belirle
shadow=Gölge
shape=Biçimlendir
shapes=Şekiller
share=Paylaş
shareLink=Paylaşılan düzenlemeye bağlantı
sharingServerNotice=Dikkat: Deneysel özellik. Kullanmanın sorumluluğu size aittir!
sharingServerReady=Paylaşım sunucusu hazır.
sharingServerUnavailable=Paylaşım sunucusu mevcut değil.
signOut=Oturumu kapat
size=Boyut
sourceSpacing=Kaynak boşluğu
south=Güney
spacing=Boşluk
specialLink=Special link
starting=Starting
straight=Doğru
strokeColor=Çizgi rengi
style=Biçim
subscript=Subscript
superscript=Superscript
support=Support
targetSpacing=Hedef boşluğu
template=Template
text=Metin
textAlignment=Metin hizalama
textOpacity=Metin bulanıklığı
tilt=Tilt
timeout=Timeout
toBack=Arkaya
toFront=Öne
tooltips=Araç bilgisi
top=Üst
topAlign=Üst hizala
transparent=Saydam
underline=Altını çiz
undo=Geri al
ungroup=Grubu dağıt
unsavedChanges=Unsaved changes
untitledDiagram=Untitled Diagram
unknownError=Unknown error
updatingDocument=Dokümanı güncelliyor. Lütfen bekleyin...
updatingSelection=Seçimi güncelliyor. Lütfen bekleyin...
url=URL
vertical=Dikey
verticalFlow=Dikey akış
verticalTree=Dikey şema
view=Görüntüle
west=Batı
width=Genişlik
wordWrap=Word wrap
zoom=Yakınlaştır
zoomIn=Büyült
zoomOut=Küçült
